11111
1P1E1
1CC11
11001
11111
