11111
1P1E1
1CC01
11001
11111
