111111111111111111
11000000C000000011
100001100011110001
10E00010001XX10001
10000010C011110C01
10X00010000001X001
11P0000000C0000011
111111111111111111
