111111111111111111111111111111111111
1P0000000000000000000000000000000001
111111011111111111111111111111111101
100000000000000000000000000000000001
101111111111111111011111111111111111
100000000000000000000000000000000001
111111111111111111111111111101111101
100000000000000010000000000000000001
101111101111111110111111111111111111
10000000000000000C000000000000000001
111111111111111111111111111111111101
100000000000000000000000000000000001
101111111111111101111111111111111111
100000000000000000000000000000000001
111111111111111011111111111111111101
1E0000000000000000000000000000000001
111111111111111111111111111111111111
